ach-prod	Acheter un produit ou un service
anal-pub	Analyser une publicité
com-écr	Communiquer par écrit
écr-tél	Communiquer par écrit & téléphone
com-tél	Communiquer par téléphone
cré-pub	Créer une publicité
décr-poste	Décrocher un poste
en-voyaff	En voyage d'affaires
étu-march	Faire une étude de marché
nég-inter	Négocier à l'international
prm-cont	Premier contact
prés-prpro	Présenter son projet professionnel
prés-buspl	Présenter un business plan
prés-entr	Présenter une entreprise
prés-ville	Présenter une ville étrangère
réun-sol	Se réunir pour trouver des solutions
vend-prod	Vendre un produit ou un service
vivr-étran	Vivre, étudier et travailler à l'étranger

## Abréviations pour noms de fichiers (sans accents)

ach-prod	Acheter un produit ou un service
anal-pub	Analyser une publicité
com-ecr	Communiquer par écrit
ecr-tel	Communiquer par écrit & téléphone
com-tel	Communiquer par téléphone
cre-pub	Créer une publicité
decr-poste	Décrocher un poste
en-voyaff	En voyage d'affaires
etu-march	Faire une étude de marché
neg-inter	Négocier à l'international
prm-cont	Premier contact
pres-prpro	Présenter son projet professionnel
pres-buspl	Présenter un business plan
pres-entr	Présenter une entreprise
pres-ville	Présenter une ville étrangère
reun-sol	Se réunir pour trouver des solutions
vend-prod	Vendre un produit ou un service
vivr-etran	Vivre, étudier et travailler à l'étranger
